	xxxxxxxxxxxxx -> width
y	1111111111111
y	10010000000C1
y	1000011111001
y	1P011E0000001
y	1111111111111
y-> height	

