1111111111111
1001000C00011
1000011111001
1011E0000011
1111111111111