1111111111111
10010000001C1
1P011E0000101
1111111111111