1111111
1P00C01
100C101
1000E01
1111111