111111
100001
101P01
100E01
111111
