1111111
1P00001
100C101
1000E01
1111111