1111111
1000C01
100C101
1000E01
1111111